Dave_Chappelle	entertainment
Chuck_Barris	entertainment
Gudi_Padwa	history
Subrogation	politics
Tobias_Ellwood	politics
Death_Note	entertainment
2018_FIFA_World_Cup_qualification	sports
Ken_Jeong	entertainment
Devin_Booker	sports
Denis_Voronenkov	politics,history
Humanz	entertainment
Freedom_Caucus	politics
Down_syndrome	techScience
Gorillaz	entertainment
Ulysses_S._Grant	politics
Music_Meister	entertainment
Madalyn_Murray_O'Hair	politics,history
Ava_Gardner	entertainment
BuzzFeed	entertainment
2018_FIFA_World_Cup_qualification_(UEFA)	sports
Death_Note_(2017_film)	entertainment
Jonathan_Taylor_Thomas	entertainment
Lukas_Podolski	sports
Chevy_Chase	entertainment
Brontë_family	entertainment
Rio_Ferdinand	sports
Uday_Hussein	politics
Paul_Erdős	techScience
Marcus_Stroman	sports
List_of_National_Basketball_Association_single-game_scoring_leaders	sports
Abu_Izzadeen	history
Dry_county	politics
Gunfoundry	history
Gauss–Seidel_method	techScience
Lauren_Morelli	history
Molotov_bread_basket	history
Hassan_Fathy	history,techScience
Meow_(cat)	entertainment
PXL-2000	entertainment
Marozia	history
